@ Level 1
0b00001000
0b00000000
0b00000000

@ Level 2
0b00010100
0b00000000

@ Level 3
0b01000000
0b00100000
0b00010000
0b00010000
0b00001000
0b00000100
0b00000010
0b00000001

@ Level 4
0b00111110
0b00000000
0b00000000
0b00000000
0b00000000

@ Level 5
0b00111110
0b00000000
0b00000000
0b00000000
0b00000000

@ Level 6
0b00100100
0b00010010
0b01001001

@ Level 7
0b00111111
0b00000000
0b00000000
0b00000000
0b00000000
0b00000000
0b00000000

@ Level 8
0b00100010
0b00001000
0b00010100
0b00000000
0b01000001

@ Level 9
0b01010101
0b00000000
0b00101010

@ Level 10
0b01000000
0b00000000
0b00000001
0b01000001
0b01000011
0b01000101
0b01010101
0b01001111
0b01100101
0b01000101
0b01110011
0b01111001
0b01111101
0b01111100
0b01111110
